

 22              22
+

 11              11
1> 1            1U 1
 11              11
+
                   
 11              11 
1  11111111     1  1
 11              11 
+
 
 1111111111      11 
1  E  E  E 1    1  1
 1111111111      11
+
 
         11      11
 11111111  1    1  1
         11      11
+

         11      11
        1  1    1  1
         11      11
+

         11      11
        1  1    1  1
         11      11
+

         11      11
 11     1  1    1 E1
 11      11      11
 11      11      
 11      11      
 1111111111
+

 11      11      11
1  1    1  1    1  1
1  1    1  1     11
1  1    1  1
1  111111  1
1          1
 1111111111
+

 11      11      11
1E 1     11     1  1
 11      11      11
 11      11      
 11      11      
 1111111111
       
+

 11              11
1  1            1  1
 11              11
+
                   
 11              11 
1  11111111     1  1
 11              11 
+
 
 1111111111      11 
1   E      1    1  1
 1111111111      11
+
 
         11      11
 11111111  1    1  1
         11      11
+

         11      11
        1  1    1  1
         11      11
+

         11      11
        1  1    1  1
         11      11
+

         11      11
        1  1    1  1
         11      11
         11      11
         11      11
         1111111111
+

         11      11 
        1  1    1  1
        1  1    1  1
        1  1    1  1
        1  111111  1
        1          1
         1111111111
+

         11      11
         11     1  1
         11      11
         11      11
         11      11
         1111111111
       
+

                
                 22
				 